0 0 0 0 0 0 0 0 0 0 0 0 0 0 0 3 3 3 3 2 2
0 0 0 0 0 0 0 0 0 0 0 0 0 0 0 0 0 0 3 2 2
0 0 0 0 0 0 0 0 0 0 0 0 0 0 0 0 0 0 2 2 2
0 0 0 0 0 0 0 0 0 0 0 2 0 0 0 0 0 0 0 0 2
0 0 0 3 0 0 1 1 0 0 2 2 0 0 1 0 0 0 0 0 2
0 0 0 3 1 1 1 1 2 2 2 2 2 0 1 1 0 0 0 0 0
0 0 1 1 1 1 1 1 1 1 0 2 2 2 1 1 1 0 0 0 0
0 0 0 0 0 0 0 1 1 0 0 2 2 2 1 1 1 1 1 0 0
0 0 0 0 0 0 0 1 1 0 0 2 2 5 6 7 1 1 1 0 0
0 0 0 0 0 0 0 1 1 0 2 2 2 8 9 10 1 1 0 0 0
0 0 0 0 0 0 0 1 1 0 0 0 2 11 12 13 1 1 0 0 0
0 0 0 0 0 3 1 1 1 1 1 0 0 0 0 0 1 0 0 0 3
0 0 0 2 2 3 1 1 1 1 1 1 1 0 0 0 1 0 0 3 3
0 0 0 0 2 2 2 1 1 0 0 0 0 0 0 0 0 0 0 0 2
0 0 0 0 0 0 0 0 0 0 0 0 4 4 4 0 0 0 0 0 2
0 0 0 0 0 0 0 0 0 0 0 0 0 3 3 3 0 0 0 0 2
0 0 0 0 0 0 0 0 0 0 0 0 0 0 0 0 0 0 0 0 0
2 0 0 0 0 3 3 3 0 0 0 0 0 0 0 0 0 0 0 0 0
2 0 0 0 0 0 4 4 4 0 0 0 0 0 0 0 0 0 0 0 0
2 0 0 0 0 0 0 0 0 0 0 0 1 1 2 2 2 0 0 0 0
3 3 0 0 1 0 0 0 0 1 1 1 1 1 1 3 2 2 0 0 0
3 0 0 0 1 0 0 0 0 0 1 1 1 1 1 3 0 0 0 0 0
0 0 0 1 1 5 6 7 2 0 0 0 1 1 0 3 0 0 0 0 0
0 0 0 1 1 8 9 10 2 2 2 0 1 1 0 0 0 0 0 0 0
0 0 1 1 1 11 12 13 2 2 0 0 1 1 0 0 0 0 0 0 0
0 0 1 1 1 1 1 2 2 2 0 0 1 1 1 1 0 0 0 0 0
0 0 0 0 1 1 1 2 2 2 0 1 1 1 1 1 1 1 0 0 0
0 0 0 0 0 1 1 0 2 2 2 2 2 1 1 1 1 3 0 0 0
2 0 0 0 0 0 1 0 0 2 2 0 0 1 1 0 0 3 0 0 0
2 0 0 0 0 0 0 0 0 2 0 0 0 0 0 0 0 0 0 0 0
2 2 2 0 0 0 0 0 0 0 0 0 0 0 0 0 0 0 0 0 0
2 2 3 0 0 0 0 0 0 0 0 0 0 0 0 0 0 0 0 0 0
2 2 3 3 3 3 0 0 0 0 0 0 0 0 0 0 0 0 0 0 0
